################################################################################################################# 
##          >>                           $$                      >>              %%%%           >>>            ## 
##    $$                     $$             %%%%%%%%%%%%%%       >>                  >>                        ## 
##      >>                                 %%     $$                 %%%%%%%                $$          >>     ## 
##                   $$                     %%%%%%%%%%%%%%        %%        %%           ______________________## 
##   $$                  >>                                    $$            >>          ?                     ## 
##             >>                           $$                                           |                     ## 
##                                                                 >>          %%%       |                     ## 
##               >>                     >>                         >>                    |                     ## 
##     %%%%                     >>                   $$                                  |                     ## 
##             %%%%%%%%%%%%                       >>                    >>               |                     ## 
##             %%        %%       >>                                 %%%%%%%%            |                     ## 
##              %%%%%%%%%         >>                     $              >>               |                     ## 
##           $$                >>                        >>       $     >>               |                     ## 
## >>                                     >>             $                               |                     ## 
##     >>                                  $$                  %%%%%%%%%       $$        |                     ## 
##                >>          $$                               %%     %%                 |                     ## 
##   >>                            >>     >>                          %%%%%%%%%          |                     ## 
##                                                     >>           >>                   |                     ## 
##                >>           $$                 $$                                     |                     ## 
##     %%%                                >     >>>           $             >>           |                     ## 
##             %%%%%%%%%%%%%                            >>                               |                     ## 
##             %%         %%       >>                    %%%%%%%%                        |                     ## 
##     $$      %%%%%%%%%%%%%      >>                                  >>       >>        |                     ## 
##  >>>>                                          $$                >>                   |                     ## 
##              %%%%%%%%                           >>          $$           %%%%%%       |                     ## 
##                                        >>>>           $                               |                     ## 
##      %%%%%%%%%%%                   $$                          >>                     |                     ## 
##                 >>                   $$                     >>>                       |                     ## 
##                                          %%%%%%%%%%%%%%%                              |_____________________## 
##           >>                                       >>        %%%%%%%%                                       ## 
##    $$                                    %%%%%%%%%%%%%%            $$       >>                              ## 
## >>                                     >>             $                                                     ## 
##      >>                         %%       >        %%%%%%%%                                                  ## 
################################################################################################################# 
                                                                                                                  
